+---+---+---+---+---+---+---+---+---+---+---+---+---+---+---+---+
|                   |           |           |           |       |
+   +---+   +---+   +---+   +   +---+   +   +---+   +   +---+   +
|   |       |   |           |           |           |           |
+---+   +   +   +---+   +---+---+   +---+---+   +---+---+   +---+
|       |       |   |       |           |           |           |
+   +---+---+   +   +---+   +   +---+   +   +---+   +   +---+---+
|       |       |       |       |   |       |   |       |       |
+   +   +   +---+   +---+---+---+   +---+---+   +---+   +---+   +
|   |       |                                       |       |   |
+---+   +   +---+---+   +---+   +---+   +---+   +---+   +   +   +
|       |       |               |       |       |       |       |
+   +---+---+   +   +---+   +---+   +---+   +---+   +---+---+   +
|       |       |               |   |           |       |       |
+   +   +   +---+---+   +---+---+   +   +---+   +---+   +   +---+
|   |       |               |       |               |       |   |
+---+   +   +---+   +---+   +   +   +---+   +---+---+   +   +   +
|       |       |           |       |           |       |       |
+   +---+---+   +---+   +---+---+---+   +---+   +   +---+---+   +
|       |       |                               |       |       |
+   +   +   +---+   +---+   +---+   +---+   +---+---+   +   +---+
|   |       |                                       |       |   |
+---+   +   +---+---+   +---+   +---+   +---+   +---+   +   +   +
|       |       |                               |       |       |
+   +---+---+   +   +---+   +---+---+   +---+---+   +---+---+   +
|       |       |           |       |   |       |       |       |
+   +   +   +---+   +   +---+   +   +---+   +   +---+   +   +---+
|   |       |       |           |           |       |       |   |
+---+   +---+   +   +---+   +---+---+   +---+---+   +   +---+   +
|       |       |       |       |           |           |       |
+   +---+   +   +   +   +---+   +   +---+   +   +---+   +   +---+
|   |       |   |   |       |           |           |           |
+---+---+---+---+---+---+---+---+---+---+---+---+---+---+---+---+

[14,28,6,14,14,12,22,12,4,22,12,4,22,12,4,22,24,6,24,2,8,18,12,18,24,4,18,24,4,2,24,6,14,8,6,24,2,12,16,6,12,16,6,12,18,8,6,26,8,18,24,6,8,16,6,24,18,14,24,18,12,18,24,6,24,6,12,18,24,4,16,4,20,0,20,6,24,6,12,2,14,8,2,28,4,16,4,16,4,16,4,16,22,8,2,26,8,18,24,6,24,4,16,20,16,4,16,6,12,18,24,6,24,6,12,18,12,16,6,12,6,24,4,18,24,6,12,2,14,8,2,28,16,4,18,24,2,12,16,4,22,8,2,26,8,18,24,6,12,16,4,22,10,24,4,18,12,18,24,6,24,6,12,18,24,4,16,6,24,6,24,6,24,6,12,2,14,8,2,28,4,16,20,16,4,16,20,0,22,8,18,10,8,18,24,6,8,22,12,6,26,12,6,26,12,2,28,18,24,6,12,2,26,12,18,24,4,18,24,4,18,24,4,22,14,24,2,26,12,16,6,12,16,6,12,16,6,12,16,6,24,20,16,20,18,28,16,18,28,16,18,28,16,18,28,18]