+---+---+---+---+---+---+---+---+---+---+---+---+---+---+---+---+
|                           |       |                           |
+   +---+   +---+   +---+---+   +   +---+   +---+   +---+   +---+
|                               |                               |
+---+   +---+   +---+   +---+   +   +---+---+   +---+   +---+   +
|                           |   |   |                           |
+   +---+   +---+   +---+---+   +   +---+   +---+   +---+   +---+
|                               |                               |
+---+   +---+   +---+   +---+   +   +---+---+   +---+   +---+   +
|                           |   |   |                           |
+   +---+   +---+   +---+---+   +   +---+   +---+   +---+   +---+
|                               |                               |
+---+   +---+   +---+   +---+   +   +---+---+   +---+   +---+   +
|                           |   |   |                           |
+   +---+   +---+   +---+   +---+---+---+   +---+   +---+   +---+
|                           |       |                           |
+---+   +---+   +---+   +---+   +   +   +---+   +---+   +---+   +
|                                   |                           |
+---+---+---+---+---+---+---+---+---+---+---+---+---+---+   +---+
|   |       |       |       |       |       |       |           |
+   +   +   +   +   +   +   +   +   +   +   +   +   +---+   +---+
|       |       |       |       |       |       |               |
+   +   +   +   +   +   +   +   +   +   +   +   +   +   +---+   +
|   |       |       |       |       |       |       |           |
+   +   +   +   +   +   +   +   +   +   +   +   +   +---+   +---+
|       |       |       |       |       |       |               |
+   +   +   +   +   +   +   +   +   +   +   +   +   +   +---+   +
|   |       |       |       |       |       |       |           |
+   +   +   +   +   +   +   +   +   +   +   +   +   +---+   +---+
|       |       |       |       |       |       |               |
+   +   +   +   +   +   +   +   +   +   +   +   +   +   +---+   +
|   |       |       |       |       |       |       |           |
+---+---+---+---+---+---+---+---+---+---+---+---+---+---+---+---+

[14,12,6,12,6,12,6,12,6,12,6,12,6,12,20,6,8,2,8,2,8,2,8,2,8,2,8,2,8,16,4,18,10,8,2,8,2,8,2,8,2,8,2,8,2,12,16,6,8,2,8,2,8,2,8,2,8,2,8,2,8,16,4,18,10,8,2,8,2,8,2,8,2,8,2,8,2,12,16,6,8,2,8,2,8,2,8,2,8,2,8,2,8,16,4,18,26,24,18,24,18,24,18,24,18,24,18,24,18,28,0,22,28,4,20,4,20,4,20,4,6,12,20,4,20,4,16,6,12,16,4,16,4,16,6,24,18,24,4,16,4,16,4,18,24,4,16,4,16,4,18,14,14,28,16,4,16,4,16,6,12,16,4,16,4,16,20,2,8,20,4,16,4,16,4,18,24,4,16,4,16,4,22,10,10,28,16,4,16,4,16,6,12,16,4,16,4,16,20,2,8,20,4,16,4,16,4,18,24,4,16,4,16,4,22,10,10,28,16,4,16,4,16,6,12,16,4,16,4,16,20,2,8,20,4,16,4,16,4,18,24,20,16,20,16,20,22,24,18,28,16,20,16,20,16,22]