+---+---+---+---+---+---+---+---+---+---+---+---+---+---+---+---+
|                                                       |       |
+   +---+---+   +---+---+   +---+---+   +---+---+---+   +   +   +
|   |   |   |   |   |   |   |   |   |   |           |       |   |
+   +   +   +   +   +   +   +   +   +   +   +   +---+   +---+---+
|   |       |                           |   |   |       |       |
+   +   +   +   +   +   +   +   +   +   +   +---+   +---+   +   +
|   |   |   |   |   |   |   |   |   |   |   |       |       |   |
+   +---+   +   +---+---+   +   +   +   +   +   +---+   +---+   +
|   |                               |   |       |       |   |   |
+   +---+   +   +---+---+   +   +   +   +   +---+   +---+   +   +
|   |   |   |   |   |   |   |   |   |               |       |   |
+   +   +   +---+   +   +---+   +   +---+---+---+---+   +---+   +
|   |                       |       |           |       |       |
+   +   +   +   +   +   +   +---+---+   +   +---+   +---+   +   +
|   |   |   |   |   |   |   |           |           |       |   |
+   +---+---+   +---+---+   +   +   +---+---+   +---+   +---+   +
|   |                       |       |           |       |       |
+   +   +---+   +---+   +---+---+---+   +   +---+   +---+   +   +
|   |   |   |   |   |   |   |       |   |           |       |   |
+   +---+   +---+   +---+   +   +---+---+---+   +---+   +---+   +
|                               |           |   |       |       |
+   +   +---+   +---+   +---+   +   +   +   +---+   +---+   +   +
|   |   |   |   |   |   |   |   |   |   |   |       |       |   |
+   +---+   +---+   +---+   +   +   +   +   +   +---+   +---+   +
|   |                           |       |   |   |       |       |
+   +   +---+   +---+   +---+   +   +   +   +   +   +---+   +   +
|   |   |   |   |   |   |   |   |   |   |   |       |       |   |
+   +---+   +---+   +---+   +---+   +   +   +   +---+   +---+   +
|       |       |       |       |   |   |   |   |       |       |
+   +   +   +   +   +   +   +   +   +   +   +---+   +---+   +---+
|   |       |       |       |       |                           |
+---+---+---+---+---+---+---+---+---+---+---+---+---+---+---+---+

[14,12,6,12,6,12,6,12,6,12,4,20,4,20,4,22,8,18,8,18,8,18,8,18,10,10,10,14,24,6,24,6,10,14,26,14,26,14,26,14,10,10,10,8,6,24,6,10,10,24,4,16,4,16,4,2,8,2,10,10,24,6,24,2,10,14,26,14,26,14,26,10,10,10,10,24,6,24,6,10,8,16,4,16,4,16,4,2,24,16,18,14,24,6,24,2,10,14,26,14,26,14,26,24,22,14,12,16,6,24,6,10,10,24,20,0,20,16,6,12,6,24,16,6,24,6,24,2,10,14,14,10,14,14,10,24,16,6,12,16,6,24,6,10,10,8,0,16,0,0,18,12,6,24,16,22,24,6,24,2,10,26,10,14,26,26,14,10,10,12,4,20,6,24,6,10,10,28,0,0,20,20,0,0,2,10,8,6,24,6,26,10,10,14,10,10,14,14,10,10,10,10,10,24,6,24,6,10,10,8,2,8,0,0,0,0,0,2,10,14,24,6,24,18,10,26,26,10,26,26,10,26,26,10,24,16,22,8,6,14,24,20,20,16,20,20,16,20,20,16,20,20,20,18,24,18]